NO textures/CRATE_1A.PNG
SO textures/BRICK_1B.PNG
WE textures/BRICK_2A.PNG
EA textures/DOOR_1A.PNG

F 220,100,0
C 225,30,0

1111111111111111111111111
1000000000000100000000001
1011110111110101111101111
1000010000010100000100001
1111010111010111110101111
1001010001010000010100001
1011011101111111010111111
1000000000000000000000001
100000010000W000010000001
1000000000000000000000001
1000000000000000000000001
1000000000000000000000001
1111011111110111111111011
1000000000010100000000011
1011110111010101111101111
1000010101000001000000001
1111010101111111111101011
1000000000000000000000001
1111111111111111111111111