NO assets/textures/CRATE_1A.PNG
SO assets/textures/BRICK_1B.PNG
WE assets/textures/BRICK_2A.PNG
EA assets/textures/DOOR_1A.PNG

F 220,100,0
C 100,30,0

111111111111
100010000001
101010111101
101000100101
101111101101
100000S00001
111110111111
100010100001
101010111101
101000001101
101111101101
111111111111