NO assets/textures/CRATE_1A.PNG
SO assets/textures/BRICK_1B.PNG
WE assets/textures/BRICK_2A.PNG
EA assets/textures/DOOR_1A.PNG
F 220,100,0
C 100,30,0

11111111111111111111111111111111111111111111
10000000000000000000000000000000000000000001
100W0000000000000000000000000000000000000001 
11111111111111111111111111111111111111111111
