NO assets/textures/CRATE_1A.PNG
SO assets/textures/BRICK_1B.PNG
WE assets/textures/BRICK_2A.PNG
EA assets/textures/DOOR_1A.PNG

F 220,100,0
C 225,30,0

1111111111111111111111111
1000000000000100000000001
1011110111110101111101111
1000010000010100000100001
1111010111010111110101111
100101000101000001010000111111111111111111
1011011101111111010111111000000000000000011111111111
1000000000000000000000000000000000000000000000000001
100000010000W000010000000000000000000000011111111111
100000000000000000000000111111111101111111
100000000000000000000000100000000000000001
100000000000000000000000100000000000000001
111101111111011111111101100000000000000001
100000000001010000000001100000000000000001
101111011101010111110111111111111111111111
1000010101000001000000001
1111010101111111111101011
1000000000000000000000001
1111111111111111111111111